"","Date","Time","Home","Away","Home_Score","Away_Score","Season","result","G"
"1",2013-10-10,"17:30","NZ Breakers","Illawarra Hawks",92,73,"2013/14",1,19
"2",2013-10-11,"21:30","Perth Wildcats","Adelaide 36ers",83,80,"2013/14",1,3
"3",2013-10-12,"21:00","Townsville","Cairns Taipans",92,103,"2013/14",0,11
"4",2013-10-13,"14:00","Sydney Kings","Melbourne United",73,69,"2013/14",1,4
"5",2013-10-18,"21:30","Perth Wildcats","Sydney Kings",81,69,"2013/14",1,12
"6",2013-10-18,"20:30","Townsville","NZ Breakers",94,84,"2013/14",1,10
"7",2013-10-19,"20:00","Adelaide 36ers","Illawarra Hawks",97,91,"2013/14",1,6
"8",2013-10-19,"19:30","Cairns Taipans","NZ Breakers",86,85,"2013/14",1,1
"9",2013-10-20,"14:00","Melbourne United","Perth Wildcats",71,75,"2013/14",0,4
"10",2013-10-24,"17:30","NZ Breakers","Perth Wildcats",89,96,"2013/14",0,7
"11",2013-10-25,"20:30","Cairns Taipans","Adelaide 36ers",84,87,"2013/14",0,3
"12",2013-10-26,"19:30","Illawarra Hawks","Townsville",85,81,"2013/14",1,4
"13",2013-10-27,"14:00","Melbourne United","Adelaide 36ers",93,79,"2013/14",1,14
"14",2013-10-27,"14:00","Sydney Kings","Perth Wildcats",72,82,"2013/14",0,10
"15",2013-10-31,"17:30","NZ Breakers","Adelaide 36ers",93,96,"2013/14",0,3
"16",2013-11-01,"21:30","Perth Wildcats","Illawarra Hawks",87,47,"2013/14",1,40
"17",2013-11-01,"20:30","Townsville","Sydney Kings",86,88,"2013/14",0,2
"18",2013-11-02,"20:30","Cairns Taipans","Melbourne United",74,86,"2013/14",0,12
"19",2013-11-03,"14:00","Adelaide 36ers","Sydney Kings",97,84,"2013/14",1,13
"20",2013-11-03,"14:00","Illawarra Hawks","NZ Breakers",89,97,"2013/14",0,8
"21",2013-11-08,"20:30","Townsville","NZ Breakers",91,78,"2013/14",1,13
"22",2013-11-08,"20:00","Adelaide 36ers","Melbourne United",90,87,"2013/14",1,3
"23",2013-11-08,"19:30","Sydney Kings","Cairns Taipans",99,86,"2013/14",1,13
"24",2013-11-10,"14:00","Melbourne United","Illawarra Hawks",81,76,"2013/14",1,5
"25",2013-11-14,"22:00","Perth Wildcats","Cairns Taipans",75,68,"2013/14",1,7
"26",2013-11-15,"19:30","Sydney Kings","Townsville",88,67,"2013/14",1,21
"27",2013-11-15,"17:30","NZ Breakers","Adelaide 36ers",94,95,"2013/14",0,1
"28",2013-11-16,"19:30","Melbourne United","Cairns Taipans",88,85,"2013/14",1,3
"29",2013-11-17,"14:00","Illawarra Hawks","Perth Wildcats",76,89,"2013/14",0,13
"30",2013-11-22,"20:00","Adelaide 36ers","Perth Wildcats",91,86,"2013/14",1,5
"31",2013-11-22,"17:30","NZ Breakers","Townsville",81,74,"2013/14",1,7
"32",2013-11-23,"20:30","Cairns Taipans","Illawarra Hawks",73,75,"2013/14",0,2
"33",2013-11-24,"18:00","Perth Wildcats","Sydney Kings",98,55,"2013/14",1,43
"34",2013-11-24,"14:00","Melbourne United","Townsville",75,90,"2013/14",0,15
"35",2013-11-28,"17:30","NZ Breakers","Melbourne United",84,74,"2013/14",1,10
"36",2013-11-29,"20:00","Adelaide 36ers","Illawarra Hawks",82,81,"2013/14",1,1
"37",2013-11-30,"20:30","Cairns Taipans","Perth Wildcats",75,85,"2013/14",0,10
"38",2013-12-01,"14:00","Melbourne United","Sydney Kings",63,67,"2013/14",0,4
"39",2013-12-06,"21:30","Perth Wildcats","NZ Breakers",95,91,"2013/14",1,4
"40",2013-12-06,"20:30","Townsville","Adelaide 36ers",98,94,"2013/14",1,4
"41",2013-12-07,"20:30","Cairns Taipans","Adelaide 36ers",98,78,"2013/14",1,20
"42",2013-12-07,"19:30","Illawarra Hawks","Sydney Kings",73,69,"2013/14",1,4
"43",2013-12-08,"14:00","Melbourne United","NZ Breakers",84,82,"2013/14",1,2
"44",2013-12-13,"20:30","Cairns Taipans","Townsville",87,74,"2013/14",1,13
"45",2013-12-13,"17:30","NZ Breakers","Perth Wildcats",62,71,"2013/14",0,9
"46",2013-12-14,"20:30","Townsville","Melbourne United",71,76,"2013/14",0,5
"47",2013-12-14,"19:30","Sydney Kings","Illawarra Hawks",63,69,"2013/14",0,6
"48",2013-12-15,"14:00","Adelaide 36ers","Cairns Taipans",91,67,"2013/14",1,24
"49",2013-12-27,"19:30","Melbourne United","Illawarra Hawks",74,67,"2013/14",1,7
"50",2013-12-29,"14:00","Sydney Kings","NZ Breakers",83,99,"2013/14",0,16
"51",2013-12-31,"20:30","Townsville","Adelaide 36ers",89,90,"2013/14",0,1
"52",2013-12-31,"19:30","Cairns Taipans","Perth Wildcats",99,90,"2013/14",1,9
"53",2013-12-31,"17:30","Illawarra Hawks","Melbourne United",81,91,"2013/14",0,10
"54",2014-01-03,"20:30","Townsville","Melbourne United",77,95,"2013/14",0,18
"55",2014-01-03,"19:30","Sydney Kings","Cairns Taipans",62,73,"2013/14",0,11
"56",2014-01-04,"20:00","Adelaide 36ers","NZ Breakers",99,73,"2013/14",1,26
"57",2014-01-04,"19:30","Illawarra Hawks","Perth Wildcats",96,91,"2013/14",1,5
"58",2014-01-05,"14:00","Melbourne United","Cairns Taipans",76,66,"2013/14",1,10
"59",2014-01-10,"22:00","Perth Wildcats","Townsville",102,87,"2013/14",1,15
"60",2014-01-10,"19:30","Melbourne United","NZ Breakers",87,93,"2013/14",0,6
"61",2014-01-11,"20:30","Cairns Taipans","Illawarra Hawks",79,82,"2013/14",0,3
"62",2014-01-12,"15:00","Townsville","Perth Wildcats",97,103,"2013/14",0,6
"63",2014-01-12,"14:00","Adelaide 36ers","Sydney Kings",89,102,"2013/14",0,13
"64",2014-01-17,"21:30","Perth Wildcats","NZ Breakers",97,72,"2013/14",1,25
"65",2014-01-17,"20:30","Cairns Taipans","Sydney Kings",88,92,"2013/14",0,4
"66",2014-01-18,"20:00","Adelaide 36ers","Townsville",92,79,"2013/14",1,13
"67",2014-01-19,"14:00","Illawarra Hawks","Cairns Taipans",77,79,"2013/14",0,2
"68",2014-01-19,"14:00","Sydney Kings","Melbourne United",97,84,"2013/14",1,13
"69",2014-01-23,"17:30","NZ Breakers","Illawarra Hawks",106,101,"2013/14",1,5
"70",2014-01-24,"21:30","Perth Wildcats","Melbourne United",80,83,"2013/14",0,3
"71",2014-01-24,"20:30","Townsville","Cairns Taipans",79,90,"2013/14",0,11
"72",2014-01-26,"17:30","Illawarra Hawks","Melbourne United",78,86,"2013/14",0,8
"73",2014-01-26,"14:00","Sydney Kings","Adelaide 36ers",105,93,"2013/14",1,12
"74",2014-01-30,"22:00","Perth Wildcats","Cairns Taipans",94,99,"2013/14",0,5
"75",2014-01-30,"17:30","NZ Breakers","Sydney Kings",105,87,"2013/14",1,18
"76",2014-01-31,"20:30","Townsville","Illawarra Hawks",80,67,"2013/14",1,13
"77",2014-02-01,"20:00","Adelaide 36ers","Cairns Taipans",89,87,"2013/14",1,2
"78",2014-02-02,"14:00","Melbourne United","Perth Wildcats",57,81,"2013/14",0,24
"79",2014-02-07,"20:30","Townsville","Perth Wildcats",88,75,"2013/14",1,13
"80",2014-02-08,"20:30","Cairns Taipans","Townsville",82,90,"2013/14",0,8
"81",2014-02-08,"19:30","Sydney Kings","NZ Breakers",98,96,"2013/14",1,2
"82",2014-02-09,"14:00","Illawarra Hawks","Adelaide 36ers",102,80,"2013/14",1,22
"83",2014-02-14,"22:00","Perth Wildcats","Adelaide 36ers",85,61,"2013/14",1,24
"84",2014-02-14,"19:30","Illawarra Hawks","Townsville",90,75,"2013/14",1,15
"85",2014-02-14,"17:30","NZ Breakers","Cairns Taipans",96,78,"2013/14",1,18
"86",2014-02-15,"19:30","Sydney Kings","Illawarra Hawks",84,102,"2013/14",0,18
"87",2014-02-16,"14:00","Melbourne United","Adelaide 36ers",82,99,"2013/14",0,17
"88",2014-02-21,"22:00","Perth Wildcats","Melbourne United",87,75,"2013/14",1,12
"89",2014-02-21,"20:30","Cairns Taipans","Sydney Kings",63,85,"2013/14",0,22
"90",2014-02-21,"19:30","Illawarra Hawks","NZ Breakers",88,68,"2013/14",1,20
"91",2014-02-22,"20:30","Townsville","Sydney Kings",90,83,"2013/14",1,7
"92",2014-02-23,"14:00","Adelaide 36ers","NZ Breakers",96,92,"2013/14",1,4
"93",2014-02-27,"17:30","NZ Breakers","Townsville",102,99,"2013/14",1,3
"94",2014-02-28,"19:30","Illawarra Hawks","Adelaide 36ers",91,89,"2013/14",1,2
"95",2014-03-01,"20:30","Cairns Taipans","NZ Breakers",92,87,"2013/14",1,5
"96",2014-03-01,"19:30","Melbourne United","Townsville",106,109,"2013/14",0,3
"97",2014-03-02,"13:00","Sydney Kings","Perth Wildcats",81,85,"2013/14",0,4
"98",2014-03-07,"21:30","Perth Wildcats","Townsville",81,69,"2013/14",1,12
"99",2014-03-07,"17:30","NZ Breakers","Melbourne United",84,97,"2013/14",0,13
"100",2014-03-08,"20:00","Adelaide 36ers","Townsville",102,70,"2013/14",1,32
"101",2014-03-08,"19:30","Illawarra Hawks","Cairns Taipans",79,82,"2013/14",0,3
"102",2014-03-09,"13:00","Melbourne United","Sydney Kings",92,82,"2013/14",1,10
"103",2014-03-13,"17:30","NZ Breakers","Sydney Kings",106,78,"2013/14",1,28
"104",2014-03-14,"20:30","Cairns Taipans","Melbourne United",66,73,"2013/14",0,7
"105",2014-03-14,"20:30","Townsville","Illawarra Hawks",85,94,"2013/14",0,9
"106",2014-03-14,"20:00","Adelaide 36ers","Perth Wildcats",102,79,"2013/14",1,23
"107",2014-03-16,"13:00","Sydney Kings","Adelaide 36ers",100,90,"2013/14",1,10
"108",2014-03-21,"19:30","Illawarra Hawks","Sydney Kings",100,87,"2013/14",1,13
"109",2014-03-21,"17:30","NZ Breakers","Cairns Taipans",83,95,"2013/14",0,12
"110",2014-03-22,"19:30","Sydney Kings","Townsville",79,88,"2013/14",0,9
"111",2014-03-23,"17:00","Perth Wildcats","Illawarra Hawks",86,65,"2013/14",1,21
"112",2014-03-23,"13:00","Adelaide 36ers","Melbourne United",99,94,"2013/14",1,5
"113",2014-03-27,"19:30","Adelaide 36ers","Melbourne United",101,85,"2013/14",1,16
"114",2014-03-28,"21:30","Perth Wildcats","Illawarra Hawks",91,79,"2013/14",1,12
"115",2014-03-30,"15:00","Illawarra Hawks","Perth Wildcats",61,80,"2013/14",0,19
"116",2014-03-30,"13:00","Melbourne United","Adelaide 36ers",98,87,"2013/14",1,11
"117",2014-04-01,"19:30","Adelaide 36ers","Melbourne United",102,63,"2013/14",1,39
"118",2014-04-07,"21:30","Perth Wildcats","Adelaide 36ers",92,85,"2013/14",1,7
"119",2014-04-11,"19:30","Adelaide 36ers","Perth Wildcats",89,84,"2013/14",1,5
"120",2014-04-13,"13:00","Perth Wildcats","Adelaide 36ers",93,59,"2013/14",1,34
"121",2014-10-10,"21:30","Perth Wildcats","NZ Breakers",70,80,"2014/15",0,10
"122",2014-10-10,"20:00","Adelaide 36ers","Cairns Taipans",87,97,"2014/15",0,10
"123",2014-10-10,"19:30","Illawarra Hawks","Townsville",92,83,"2014/15",1,9
"124",2014-10-11,"19:30","Sydney Kings","Illawarra Hawks",86,83,"2014/15",1,3
"125",2014-10-12,"17:00","Townsville","Adelaide 36ers",83,97,"2014/15",0,14
"126",2014-10-12,"14:00","Melbourne United","Cairns Taipans",61,89,"2014/15",0,28
"127",2014-10-17,"21:30","Perth Wildcats","Illawarra Hawks",69,59,"2014/15",1,10
"128",2014-10-17,"20:30","Cairns Taipans","Melbourne United",88,73,"2014/15",1,15
"129",2014-10-17,"19:30","Sydney Kings","Townsville",81,86,"2014/15",0,5
"130",2014-10-17,"17:30","NZ Breakers","Adelaide 36ers",101,80,"2014/15",1,21
"131",2014-10-19,"17:00","Illawarra Hawks","Cairns Taipans",89,91,"2014/15",0,2
"132",2014-10-19,"14:00","Melbourne United","NZ Breakers",95,74,"2014/15",1,21
"133",2014-10-23,"20:00","Adelaide 36ers","Illawarra Hawks",94,73,"2014/15",1,21
"134",2014-10-23,"17:30","NZ Breakers","Cairns Taipans",76,85,"2014/15",0,9
"135",2014-10-24,"21:30","Perth Wildcats","Sydney Kings",84,63,"2014/15",1,21
"136",2014-10-25,"20:30","Townsville","Melbourne United",92,81,"2014/15",1,11
"137",2014-10-26,"14:00","Illawarra Hawks","NZ Breakers",77,79,"2014/15",0,2
"138",2014-10-31,"19:30","Illawarra Hawks","Perth Wildcats",64,83,"2014/15",0,19
"139",2014-10-31,"17:30","NZ Breakers","Townsville",84,70,"2014/15",1,14
"140",2014-11-01,"20:30","Cairns Taipans","Sydney Kings",74,62,"2014/15",1,12
"141",2014-11-02,"17:00","Townsville","Perth Wildcats",102,80,"2014/15",1,22
"142",2014-11-02,"14:00","Adelaide 36ers","NZ Breakers",93,86,"2014/15",1,7
"143",2014-11-02,"14:00","Melbourne United","Illawarra Hawks",88,75,"2014/15",1,13
"144",2014-11-07,"20:30","Cairns Taipans","NZ Breakers",71,79,"2014/15",0,8
"145",2014-11-07,"19:30","Illawarra Hawks","Sydney Kings",53,82,"2014/15",0,29
"146",2014-11-09,"17:00","Perth Wildcats","Melbourne United",68,59,"2014/15",1,9
"147",2014-11-09,"17:00","Townsville","NZ Breakers",80,87,"2014/15",0,7
"148",2014-11-09,"14:00","Sydney Kings","Adelaide 36ers",107,100,"2014/15",1,7
"149",2014-11-12,"19:00","Melbourne United","Cairns Taipans",91,76,"2014/15",1,15
"150",2014-11-14,"21:30","Perth Wildcats","Townsville",93,78,"2014/15",1,15
"151",2014-11-14,"17:30","NZ Breakers","Illawarra Hawks",71,55,"2014/15",1,16
"152",2014-11-15,"20:00","Adelaide 36ers","Melbourne United",79,118,"2014/15",0,39
"153",2014-11-16,"14:00","Sydney Kings","Perth Wildcats",66,85,"2014/15",0,19
"154",2014-11-20,"19:30","Sydney Kings","Cairns Taipans",93,76,"2014/15",1,17
"155",2014-11-21,"20:00","Adelaide 36ers","Perth Wildcats",74,84,"2014/15",0,10
"156",2014-11-21,"17:30","NZ Breakers","Melbourne United",80,72,"2014/15",1,8
"157",2014-11-22,"20:30","Cairns Taipans","Illawarra Hawks",69,65,"2014/15",1,4
"158",2014-11-23,"20:30","Townsville","Illawarra Hawks",107,75,"2014/15",1,32
"159",2014-11-23,"14:00","Melbourne United","Perth Wildcats",91,76,"2014/15",1,15
"160",2014-11-27,"19:00","Melbourne United","Adelaide 36ers",94,91,"2014/15",1,3
"161",2014-11-28,"21:30","Perth Wildcats","Cairns Taipans",84,66,"2014/15",1,18
"162",2014-11-28,"19:30","Illawarra Hawks","Townsville",90,76,"2014/15",1,14
"163",2014-11-28,"17:30","NZ Breakers","Sydney Kings",107,96,"2014/15",1,11
"164",2014-11-30,"17:00","Cairns Taipans","Townsville",91,82,"2014/15",1,9
"165",2014-11-30,"14:00","Adelaide 36ers","Sydney Kings",83,90,"2014/15",0,7
"166",2014-12-05,"21:30","Perth Wildcats","Illawarra Hawks",79,55,"2014/15",1,24
"167",2014-12-05,"20:30","Townsville","Adelaide 36ers",96,84,"2014/15",1,12
"168",2014-12-06,"20:30","Cairns Taipans","Adelaide 36ers",85,80,"2014/15",1,5
"169",2014-12-06,"19:30","Sydney Kings","NZ Breakers",82,69,"2014/15",1,13
"170",2014-12-07,"14:00","Melbourne United","Townsville",83,79,"2014/15",1,4
"171",2014-12-11,"17:30","NZ Breakers","Perth Wildcats",77,66,"2014/15",1,11
"172",2014-12-12,"20:30","Cairns Taipans","Townsville",77,61,"2014/15",1,16
"173",2014-12-12,"20:00","Adelaide 36ers","Melbourne United",90,77,"2014/15",1,13
"174",2014-12-13,"19:30","Illawarra Hawks","Sydney Kings",82,77,"2014/15",1,5
"175",2014-12-14,"17:00","Perth Wildcats","Adelaide 36ers",97,76,"2014/15",1,21
"176",2014-12-14,"14:00","Melbourne United","NZ Breakers",87,92,"2014/15",0,5
"177",2014-12-18,"19:30","Sydney Kings","Perth Wildcats",78,74,"2014/15",1,4
"178",2014-12-19,"20:00","Adelaide 36ers","Cairns Taipans",90,86,"2014/15",1,4
"179",2014-12-19,"19:30","Illawarra Hawks","Melbourne United",98,103,"2014/15",0,5
"180",2014-12-19,"17:30","NZ Breakers","Townsville",96,84,"2014/15",1,12
"181",2014-12-21,"17:00","Cairns Taipans","NZ Breakers",83,59,"2014/15",1,24
"182",2014-12-21,"14:00","Melbourne United","Sydney Kings",105,101,"2014/15",1,4
"183",2014-12-26,"19:30","Sydney Kings","NZ Breakers",85,97,"2014/15",0,12
"184",2014-12-27,"20:00","Adelaide 36ers","Townsville",91,84,"2014/15",1,7
"185",2014-12-27,"19:30","Illawarra Hawks","Cairns Taipans",93,100,"2014/15",0,7
"186",2014-12-28,"14:00","Melbourne United","Perth Wildcats",80,81,"2014/15",0,1
"187",2014-12-31,"20:30","Townsville","Sydney Kings",93,92,"2014/15",1,1
"188",2014-12-31,"19:30","Cairns Taipans","Adelaide 36ers",77,84,"2014/15",0,7
"189",2014-12-31,"17:30","Illawarra Hawks","Perth Wildcats",77,86,"2014/15",0,9
"190",2015-01-02,"19:30","Sydney Kings","Melbourne United",68,82,"2014/15",0,14
"191",2015-01-03,"20:30","Townsville","Cairns Taipans",75,79,"2014/15",0,4
"192",2015-01-04,"14:00","Adelaide 36ers","NZ Breakers",74,81,"2014/15",0,7
"193",2015-01-08,"17:30","NZ Breakers","Illawarra Hawks",98,91,"2014/15",1,7
"194",2015-01-09,"20:30","Cairns Taipans","Perth Wildcats",91,76,"2014/15",1,15
"195",2015-01-09,"19:30","Sydney Kings","Townsville",89,98,"2014/15",0,9
"196",2015-01-10,"19:00","Melbourne United","Adelaide 36ers",89,91,"2014/15",0,2
"197",2015-01-11,"17:00","Townsville","Cairns Taipans",73,78,"2014/15",0,5
"198",2015-01-11,"14:00","Illawarra Hawks","NZ Breakers",84,86,"2014/15",0,2
"199",2015-01-16,"21:30","Perth Wildcats","Adelaide 36ers",102,106,"2014/15",0,4
"200",2015-01-16,"20:30","Townsville","Sydney Kings",81,89,"2014/15",0,8
"201",2015-01-17,"20:30","Cairns Taipans","Sydney Kings",80,76,"2014/15",1,4
"202",2015-01-18,"14:00","Adelaide 36ers","Illawarra Hawks",83,78,"2014/15",1,5
"203",2015-01-18,"14:00","NZ Breakers","Melbourne United",88,75,"2014/15",1,13
"204",2015-01-21,"22:00","Perth Wildcats","Melbourne United",78,86,"2014/15",0,8
"205",2015-01-23,"20:30","Townsville","Perth Wildcats",85,93,"2014/15",0,8
"206",2015-01-23,"19:30","Illawarra Hawks","Adelaide 36ers",85,89,"2014/15",0,4
"207",2015-01-23,"17:30","NZ Breakers","Sydney Kings",81,101,"2014/15",0,20
"208",2015-01-24,"20:30","Cairns Taipans","Perth Wildcats",92,66,"2014/15",1,26
"209",2015-01-25,"19:00","Melbourne United","Townsville",69,81,"2014/15",0,12
"210",2015-01-25,"14:00","Sydney Kings","Adelaide 36ers",86,105,"2014/15",0,19
"211",2015-01-29,"17:30","NZ Breakers","Perth Wildcats",90,79,"2014/15",1,11
"212",2015-01-30,"19:30","Illawarra Hawks","Melbourne United",93,82,"2014/15",1,11
"213",2015-02-01,"17:00","Cairns Taipans","Illawarra Hawks",63,60,"2014/15",1,3
"214",2015-02-01,"17:00","Perth Wildcats","Sydney Kings",80,61,"2014/15",1,19
"215",2015-02-01,"14:00","Adelaide 36ers","Townsville",84,77,"2014/15",1,7
"216",2015-02-06,"21:30","Perth Wildcats","Cairns Taipans",65,54,"2014/15",1,11
"217",2015-02-06,"20:00","Adelaide 36ers","Sydney Kings",97,78,"2014/15",1,19
"218",2015-02-07,"20:30","Townsville","NZ Breakers",79,71,"2014/15",1,8
"219",2015-02-07,"19:00","Melbourne United","Illawarra Hawks",76,82,"2014/15",0,6
"220",2015-02-08,"14:00","Sydney Kings","Cairns Taipans",78,92,"2014/15",0,14
"221",2015-02-12,"17:30","NZ Breakers","Adelaide 36ers",88,93,"2014/15",0,5
"222",2015-02-13,"20:30","Cairns Taipans","Melbourne United",84,62,"2014/15",1,22
"223",2015-02-14,"20:30","Townsville","Melbourne United",105,68,"2014/15",1,37
"224",2015-02-15,"17:00","Perth Wildcats","NZ Breakers",87,89,"2014/15",0,2
"225",2015-02-15,"14:00","Sydney Kings","Illawarra Hawks",73,75,"2014/15",0,2
"226",2015-02-20,"20:30","Townsville","Illawarra Hawks",82,66,"2014/15",1,16
"227",2015-02-20,"20:00","Adelaide 36ers","Perth Wildcats",101,94,"2014/15",1,7
"228",2015-02-20,"19:30","Sydney Kings","Melbourne United",88,91,"2014/15",0,3
"229",2015-02-22,"17:00","Illawarra Hawks","Adelaide 36ers",85,105,"2014/15",0,20
"230",2015-02-22,"17:00","Perth Wildcats","Townsville",81,71,"2014/15",1,10
"231",2015-02-22,"14:00","Melbourne United","Sydney Kings",95,92,"2014/15",1,3
"232",2015-02-22,"14:00","NZ Breakers","Cairns Taipans",77,81,"2014/15",0,4
"233",2015-02-26,"17:30","NZ Breakers","Adelaide 36ers",111,82,"2014/15",1,29
"234",2015-02-27,"20:30","Cairns Taipans","Perth Wildcats",71,64,"2014/15",1,7
"235",2015-02-28,"20:00","Adelaide 36ers","NZ Breakers",83,94,"2014/15",0,11
"236",2015-03-01,"21:30","Perth Wildcats","Cairns Taipans",68,80,"2014/15",0,12
"237",2015-03-06,"20:30","Cairns Taipans","NZ Breakers",71,86,"2014/15",0,15
"238",2015-03-08,"13:00","NZ Breakers","Cairns Taipans",83,81,"2014/15",1,2
"239",2015-10-08,"19:30","Cairns Taipans","Illawarra Hawks",79,74,"2015/16",1,5
"240",2015-10-09,"19:30","Townsville","Melbourne United",84,99,"2015/16",0,15
"241",2015-10-10,"19:30","Adelaide 36ers","Perth Wildcats",66,79,"2015/16",0,13
"242",2015-10-10,"17:30","Sydney Kings","Cairns Taipans",87,63,"2015/16",1,24
"243",2015-10-11,"15:00","Melbourne United","Illawarra Hawks",93,81,"2015/16",1,12
"244",2015-10-11,"13:00","NZ Breakers","Townsville",89,81,"2015/16",1,8
"245",2015-10-14,"19:30","Illawarra Hawks","NZ Breakers",96,75,"2015/16",1,21
"246",2015-10-15,"19:30","Sydney Kings","Townsville",77,80,"2015/16",0,3
"247",2015-10-16,"21:30","Perth Wildcats","NZ Breakers",83,80,"2015/16",1,3
"248",2015-10-16,"19:30","Melbourne United","Adelaide 36ers",84,75,"2015/16",1,9
"249",2015-10-17,"19:30","Cairns Taipans","Townsville",80,74,"2015/16",1,6
"250",2015-10-17,"17:30","Sydney Kings","Illawarra Hawks",86,100,"2015/16",0,14
"251",2015-10-21,"19:30","Melbourne United","Townsville",93,62,"2015/16",1,31
"252",2015-10-21,"17:30","NZ Breakers","Sydney Kings",74,62,"2015/16",1,12
"253",2015-10-22,"19:30","Adelaide 36ers","Cairns Taipans",88,79,"2015/16",1,9
"254",2015-10-23,"21:30","Perth Wildcats","Townsville",63,66,"2015/16",0,3
"255",2015-10-23,"19:30","Sydney Kings","Adelaide 36ers",80,91,"2015/16",0,11
"256",2015-10-24,"19:30","Melbourne United","Cairns Taipans",89,80,"2015/16",1,9
"257",2015-10-25,"15:00","Illawarra Hawks","Perth Wildcats",99,106,"2015/16",0,7
"258",2015-10-28,"19:30","Townsville","Illawarra Hawks",88,96,"2015/16",0,8
"259",2015-10-28,"17:30","NZ Breakers","Cairns Taipans",90,67,"2015/16",1,23
"260",2015-10-29,"19:30","Melbourne United","Perth Wildcats",75,73,"2015/16",1,2
"261",2015-10-30,"19:30","Sydney Kings","Townsville",87,78,"2015/16",1,9
"262",2015-10-31,"21:30","Perth Wildcats","Illawarra Hawks",91,62,"2015/16",1,29
"263",2015-10-31,"19:30","Adelaide 36ers","Cairns Taipans",101,104,"2015/16",0,3
"264",2015-11-01,"15:00","Melbourne United","Sydney Kings",96,82,"2015/16",1,14
"265",2015-11-04,"19:30","Townsville","Perth Wildcats",89,77,"2015/16",1,12
"266",2015-11-05,"19:30","Sydney Kings","Melbourne United",94,105,"2015/16",0,11
"267",2015-11-05,"17:30","NZ Breakers","Adelaide 36ers",98,88,"2015/16",1,10
"268",2015-11-06,"21:30","Perth Wildcats","Townsville",85,77,"2015/16",1,8
"269",2015-11-06,"19:30","Illawarra Hawks","Cairns Taipans",96,88,"2015/16",1,8
"270",2015-11-07,"19:30","Adelaide 36ers","Sydney Kings",99,98,"2015/16",1,1
"271",2015-11-08,"15:00","Melbourne United","NZ Breakers",87,86,"2015/16",1,1
"272",2015-11-11,"19:30","Illawarra Hawks","Perth Wildcats",96,99,"2015/16",0,3
"273",2015-11-12,"19:30","Sydney Kings","Adelaide 36ers",106,84,"2015/16",1,22
"274",2015-11-13,"19:30","Cairns Taipans","Melbourne United",82,70,"2015/16",1,12
"275",2015-11-13,"17:30","NZ Breakers","Perth Wildcats",88,80,"2015/16",1,8
"276",2015-11-14,"19:30","Adelaide 36ers","Townsville",89,65,"2015/16",1,24
"277",2015-11-18,"19:30","Adelaide 36ers","Perth Wildcats",88,94,"2015/16",0,6
"278",2015-11-19,"19:30","Sydney Kings","NZ Breakers",74,86,"2015/16",0,12
"279",2015-11-20,"19:30","Melbourne United","Townsville",78,82,"2015/16",0,4
"280",2015-11-21,"19:30","Adelaide 36ers","Illawarra Hawks",89,77,"2015/16",1,12
"281",2015-11-22,"19:00","Perth Wildcats","Cairns Taipans",91,90,"2015/16",1,1
"282",2015-11-22,"15:00","NZ Breakers","Melbourne United",80,69,"2015/16",1,11
"283",2015-11-25,"19:30","Illawarra Hawks","Sydney Kings",96,90,"2015/16",1,6
"284",2015-11-26,"19:30","Townsville","Melbourne United",63,66,"2015/16",0,3
"285",2015-11-27,"21:30","Perth Wildcats","NZ Breakers",86,80,"2015/16",1,6
"286",2015-11-27,"19:30","Cairns Taipans","Adelaide 36ers",83,88,"2015/16",0,5
"287",2015-11-28,"19:30","Illawarra Hawks","Townsville",108,70,"2015/16",1,38
"288",2015-12-02,"19:30","Townsville","Cairns Taipans",90,76,"2015/16",1,14
"289",2015-12-02,"17:30","NZ Breakers","Perth Wildcats",99,78,"2015/16",1,21
"290",2015-12-03,"19:30","Illawarra Hawks","Melbourne United",102,87,"2015/16",1,15
"291",2015-12-04,"21:30","Perth Wildcats","Adelaide 36ers",90,72,"2015/16",1,18
"292",2015-12-04,"19:30","Cairns Taipans","Sydney Kings",101,83,"2015/16",1,18
"293",2015-12-05,"19:30","Townsville","NZ Breakers",75,86,"2015/16",0,11
"294",2015-12-06,"15:00","Melbourne United","Adelaide 36ers",89,86,"2015/16",1,3
"295",2015-12-09,"19:30","Illawarra Hawks","Cairns Taipans",97,82,"2015/16",1,15
"296",2015-12-10,"21:30","Perth Wildcats","Melbourne United",113,83,"2015/16",1,30
"297",2015-12-10,"19:30","Townsville","Adelaide 36ers",101,100,"2015/16",1,1
"298",2015-12-11,"19:30","Cairns Taipans","Illawarra Hawks",103,101,"2015/16",1,2
"299",2015-12-11,"17:30","NZ Breakers","Sydney Kings",96,84,"2015/16",1,12
"300",2015-12-12,"19:30","Adelaide 36ers","Townsville",76,66,"2015/16",1,10
"301",2015-12-13,"15:00","Sydney Kings","Perth Wildcats",69,87,"2015/16",0,18
"302",2015-12-16,"19:30","Melbourne United","Sydney Kings",81,96,"2015/16",0,15
"303",2015-12-17,"19:30","Cairns Taipans","Perth Wildcats",70,73,"2015/16",0,3
"304",2015-12-18,"19:30","Illawarra Hawks","Sydney Kings",102,83,"2015/16",1,19
"305",2015-12-19,"19:30","Townsville","Perth Wildcats",75,58,"2015/16",1,17
"306",2015-12-20,"15:00","NZ Breakers","Illawarra Hawks",83,107,"2015/16",0,24
"307",2015-12-23,"19:30","Adelaide 36ers","Melbourne United",91,81,"2015/16",1,10
"308",2015-12-27,"19:00","Melbourne United","Perth Wildcats",92,87,"2015/16",1,5
"309",2015-12-27,"15:00","Sydney Kings","NZ Breakers",83,93,"2015/16",0,10
"310",2015-12-30,"19:30","Sydney Kings","Melbourne United",90,100,"2015/16",0,10
"311",2015-12-31,"19:30","Cairns Taipans","NZ Breakers",73,66,"2015/16",1,7
"312",2015-12-31,"19:30","Townsville","Illawarra Hawks",74,98,"2015/16",0,24
"313",2016-01-02,"19:30","Sydney Kings","Cairns Taipans",87,77,"2015/16",1,10
"314",2016-01-06,"19:30","Cairns Taipans","Perth Wildcats",71,61,"2015/16",1,10
"315",2016-01-07,"19:30","Melbourne United","Illawarra Hawks",97,96,"2015/16",1,1
"316",2016-01-08,"19:30","Cairns Taipans","Townsville",75,61,"2015/16",1,14
"317",2016-01-08,"17:30","NZ Breakers","Adelaide 36ers",81,87,"2015/16",0,6
"318",2016-01-09,"19:30","Sydney Kings","Illawarra Hawks",90,114,"2015/16",0,24
"319",2016-01-13,"19:30","Cairns Taipans","Melbourne United",65,83,"2015/16",0,18
"320",2016-01-14,"19:30","Illawarra Hawks","NZ Breakers",87,69,"2015/16",1,18
"321",2016-01-15,"21:30","Perth Wildcats","Sydney Kings",95,68,"2015/16",1,27
"322",2016-01-15,"19:30","Melbourne United","Cairns Taipans",98,68,"2015/16",1,30
"323",2016-01-16,"19:30","Townsville","Adelaide 36ers",103,108,"2015/16",0,5
"324",2016-01-17,"15:00","NZ Breakers","Illawarra Hawks",96,103,"2015/16",0,7
"325",2016-01-20,"19:30","Adelaide 36ers","Sydney Kings",96,89,"2015/16",1,7
"326",2016-01-21,"21:30","Perth Wildcats","Illawarra Hawks",95,72,"2015/16",1,23
"327",2016-01-21,"19:30","Townsville","NZ Breakers",89,66,"2015/16",1,23
"328",2016-01-22,"19:30","Adelaide 36ers","Melbourne United",90,81,"2015/16",1,9
"329",2016-01-23,"19:30","Cairns Taipans","NZ Breakers",90,87,"2015/16",1,3
"330",2016-01-25,"21:30","Perth Wildcats","Cairns Taipans",84,74,"2015/16",1,10
"331",2016-01-27,"19:30","Townsville","Sydney Kings",96,88,"2015/16",1,8
"332",2016-01-28,"19:30","Illawarra Hawks","Adelaide 36ers",104,97,"2015/16",1,7
"333",2016-01-29,"21:30","Perth Wildcats","Melbourne United",85,91,"2015/16",0,6
"334",2016-01-29,"19:30","Cairns Taipans","Sydney Kings",81,76,"2015/16",1,5
"335",2016-01-29,"17:30","NZ Breakers","Townsville",77,74,"2015/16",1,3
"336",2016-01-30,"19:30","Adelaide 36ers","Illawarra Hawks",104,90,"2015/16",1,14
"337",2016-02-03,"19:30","Adelaide 36ers","NZ Breakers",84,106,"2015/16",0,22
"338",2016-02-04,"19:30","Illawarra Hawks","Melbourne United",73,80,"2015/16",0,7
"339",2016-02-05,"21:30","Perth Wildcats","Sydney Kings",95,81,"2015/16",1,14
"340",2016-02-05,"19:30","Cairns Taipans","Adelaide 36ers",95,89,"2015/16",1,6
"341",2016-02-06,"19:30","Illawarra Hawks","Townsville",104,97,"2015/16",1,7
"342",2016-02-07,"15:00","NZ Breakers","Cairns Taipans",85,74,"2015/16",1,11
"343",2016-02-10,"19:30","Sydney Kings","Perth Wildcats",103,77,"2015/16",1,26
"344",2016-02-11,"19:30","Townsville","Cairns Taipans",85,68,"2015/16",1,17
"345",2016-02-12,"19:30","Illawarra Hawks","Adelaide 36ers",106,95,"2015/16",1,11
"346",2016-02-12,"17:30","NZ Breakers","Melbourne United",100,63,"2015/16",1,37
"347",2016-02-13,"19:30","Townsville","Sydney Kings",126,123,"2015/16",1,3
"348",2016-02-14,"19:00","Perth Wildcats","Adelaide 36ers",100,84,"2015/16",1,16
"349",2016-02-14,"15:00","Melbourne United","NZ Breakers",68,70,"2015/16",0,2
"350",2016-02-18,"19:30","Melbourne United","NZ Breakers",82,91,"2015/16",0,9
"351",2016-02-19,"21:30","Perth Wildcats","Illawarra Hawks",80,68,"2015/16",1,12
"352",2016-02-20,"17:30","NZ Breakers","Melbourne United",91,78,"2015/16",1,13
"353",2016-02-21,"15:00","Illawarra Hawks","Perth Wildcats",104,87,"2015/16",1,17
"354",2016-02-26,"21:30","Perth Wildcats","Illawarra Hawks",89,74,"2015/16",1,15
"355",2016-03-02,"21:30","Perth Wildcats","NZ Breakers",82,76,"2015/16",1,6
"356",2016-03-04,"17:30","NZ Breakers","Perth Wildcats",72,68,"2015/16",1,4
"357",2016-03-06,"17:30","Perth Wildcats","NZ Breakers",75,52,"2015/16",1,23
"358",2016-10-06,"19:30","Brisbane Bullets","Perth Wildcats",72,65,"2016//17",1,7
"359",2016-10-07,"19:30","Illawarra Hawks","Adelaide 36ers",122,88,"2016//17",1,34
"360",2016-10-07,"17:30","NZ Breakers","Melbourne United",76,71,"2016//17",1,5
"361",2016-10-08,"21:30","Perth Wildcats","Cairns Taipans",84,74,"2016//17",1,10
"362",2016-10-08,"17:30","Sydney Kings","Brisbane Bullets",73,77,"2016//17",0,4
"363",2016-10-09,"15:00","Melbourne United","Adelaide 36ers",79,87,"2016//17",0,8
"364",2016-10-13,"19:30","Illawarra Hawks","Sydney Kings",84,88,"2016//17",0,4
"365",2016-10-14,"21:30","Perth Wildcats","NZ Breakers",75,73,"2016//17",1,2
"366",2016-10-14,"19:30","Adelaide 36ers","Melbourne United",87,98,"2016//17",0,11
"367",2016-10-15,"19:30","Sydney Kings","Cairns Taipans",92,78,"2016//17",1,14
"368",2016-10-16,"19:00","Brisbane Bullets","Adelaide 36ers",93,96,"2016//17",0,3
"369",2016-10-16,"15:00","Melbourne United","Illawarra Hawks",95,83,"2016//17",1,12
"370",2016-10-20,"19:30","Melbourne United","Brisbane Bullets",78,70,"2016//17",1,8
"371",2016-10-20,"17:30","NZ Breakers","Sydney Kings",78,92,"2016//17",0,14
"372",2016-10-21,"21:30","Perth Wildcats","Illawarra Hawks",80,73,"2016//17",1,7
"373",2016-10-21,"19:30","Adelaide 36ers","Cairns Taipans",83,67,"2016//17",1,16
"374",2016-10-22,"19:30","Brisbane Bullets","NZ Breakers",88,82,"2016//17",1,6
"375",2016-10-23,"15:00","Melbourne United","Perth Wildcats",69,72,"2016//17",0,3
"376",2016-10-24,"19:30","Sydney Kings","Illawarra Hawks",90,73,"2016//17",1,17
"377",2016-10-27,"19:30","Cairns Taipans","Melbourne United",83,76,"2016//17",1,7
"378",2016-10-28,"19:30","Illawarra Hawks","Perth Wildcats",81,76,"2016//17",1,5
"379",2016-10-29,"17:30","NZ Breakers","Adelaide 36ers",119,93,"2016//17",1,26
"380",2016-10-30,"19:00","Illawarra Hawks","Cairns Taipans",83,98,"2016//17",0,15
"381",2016-10-30,"15:00","Sydney Kings","Brisbane Bullets",87,78,"2016//17",1,9
"382",2016-11-04,"19:30","Melbourne United","NZ Breakers",92,98,"2016//17",0,6
"383",2016-11-05,"21:30","Perth Wildcats","Adelaide 36ers",106,103,"2016//17",1,3
"384",2016-11-05,"19:30","Cairns Taipans","Sydney Kings",64,57,"2016//17",1,7
"385",2016-11-06,"15:00","Illawarra Hawks","Melbourne United",82,73,"2016//17",1,9
"386",2016-11-06,"13:00","NZ Breakers","Brisbane Bullets",86,70,"2016//17",1,16
"387",2016-11-07,"19:30","Sydney Kings","Cairns Taipans",79,77,"2016//17",1,2
"388",2016-11-10,"19:30","Brisbane Bullets","Sydney Kings",86,73,"2016//17",1,13
"389",2016-11-11,"17:30","NZ Breakers","Cairns Taipans",79,86,"2016//17",0,7
"390",2016-11-12,"19:30","Melbourne United","Sydney Kings",71,87,"2016//17",0,16
"391",2016-11-12,"17:30","Adelaide 36ers","Illawarra Hawks",74,85,"2016//17",0,11
"392",2016-11-13,"19:00","Perth Wildcats","NZ Breakers",86,87,"2016//17",0,1
"393",2016-11-13,"15:00","Cairns Taipans","Brisbane Bullets",76,84,"2016//17",0,8
"394",2016-11-17,"21:30","Perth Wildcats","Sydney Kings",93,80,"2016//17",1,13
"395",2016-11-18,"19:30","Melbourne United","Cairns Taipans",84,79,"2016//17",1,5
"396",2016-11-18,"17:30","NZ Breakers","Illawarra Hawks",100,85,"2016//17",1,15
"397",2016-11-19,"19:30","Sydney Kings","Perth Wildcats",83,72,"2016//17",1,11
"398",2016-11-19,"17:30","Adelaide 36ers","Brisbane Bullets",87,105,"2016//17",0,18
"399",2016-11-20,"15:00","Illawarra Hawks","NZ Breakers",109,78,"2016//17",1,31
"400",2016-11-24,"19:30","Brisbane Bullets","Adelaide 36ers",83,101,"2016//17",0,18
"401",2016-11-26,"19:30","Melbourne United","Sydney Kings",95,92,"2016//17",1,3
"402",2016-11-27,"19:00","Perth Wildcats","Illawarra Hawks",85,89,"2016//17",0,4
"403",2016-11-27,"15:00","Cairns Taipans","NZ Breakers",91,80,"2016//17",1,11
"404",2016-11-28,"19:30","Sydney Kings","Adelaide 36ers",85,91,"2016//17",0,6
"405",2016-12-01,"21:30","Perth Wildcats","Brisbane Bullets",75,90,"2016//17",0,15
"406",2016-12-02,"17:30","NZ Breakers","Illawarra Hawks",91,95,"2016//17",0,4
"407",2016-12-03,"19:40","Adelaide 36ers","Perth Wildcats",92,86,"2016//17",1,6
"408",2016-12-03,"17:30","Brisbane Bullets","Cairns Taipans",84,89,"2016//17",0,5
"409",2016-12-04,"15:00","Melbourne United","NZ Breakers",98,74,"2016//17",1,24
"410",2016-12-05,"19:30","Illawarra Hawks","Sydney Kings",93,99,"2016//17",0,6
"411",2016-12-08,"17:30","NZ Breakers","Brisbane Bullets",82,75,"2016//17",1,7
"412",2016-12-09,"21:30","Perth Wildcats","Melbourne United",92,89,"2016//17",1,3
"413",2016-12-09,"19:30","Cairns Taipans","Sydney Kings",78,86,"2016//17",0,8
"414",2016-12-10,"19:30","Brisbane Bullets","Illawarra Hawks",88,98,"2016//17",0,10
"415",2016-12-10,"17:30","Adelaide 36ers","NZ Breakers",102,92,"2016//17",1,10
"416",2016-12-11,"15:00","Sydney Kings","Melbourne United",81,88,"2016//17",0,7
"417",2016-12-12,"19:30","Cairns Taipans","Adelaide 36ers",83,96,"2016//17",0,13
"418",2016-12-15,"17:30","NZ Breakers","Perth Wildcats",69,57,"2016//17",1,12
"419",2016-12-16,"19:30","Adelaide 36ers","Sydney Kings",82,80,"2016//17",1,2
"420",2016-12-17,"19:30","Brisbane Bullets","Melbourne United",100,90,"2016//17",1,10
"421",2016-12-17,"17:30","Cairns Taipans","Illawarra Hawks",99,82,"2016//17",1,17
"422",2016-12-18,"15:00","Sydney Kings","Adelaide 36ers",96,103,"2016//17",0,7
"423",2016-12-19,"19:30","Brisbane Bullets","Illawarra Hawks",85,91,"2016//17",0,6
"424",2016-12-22,"19:30","Adelaide 36ers","Perth Wildcats",78,74,"2016//17",1,4
"425",2016-12-23,"19:30","Sydney Kings","Illawarra Hawks",75,87,"2016//17",0,12
"426",2016-12-26,"19:30","Melbourne United","Brisbane Bullets",97,59,"2016//17",1,38
"427",2016-12-29,"19:30","Cairns Taipans","Melbourne United",78,79,"2016//17",0,1
"428",2016-12-30,"19:30","Sydney Kings","NZ Breakers",85,80,"2016//17",1,5
"429",2016-12-31,"19:30","Brisbane Bullets","Cairns Taipans",93,76,"2016//17",1,17
"430",2016-12-31,"17:30","Illawarra Hawks","Perth Wildcats",87,95,"2016//17",0,8
"431",2017-01-01,"15:00","Melbourne United","Adelaide 36ers",104,73,"2016//17",1,31
"432",2017-01-05,"19:35","Adelaide 36ers","Illawarra Hawks",117,85,"2016//17",1,32
"433",2017-01-06,"19:30","Cairns Taipans","NZ Breakers",65,63,"2016//17",1,2
"434",2017-01-07,"19:30","Sydney Kings","Perth Wildcats",74,80,"2016//17",0,6
"435",2017-01-07,"17:30","Illawarra Hawks","Melbourne United",106,88,"2016//17",1,18
"436",2017-01-08,"15:00","NZ Breakers","Adelaide 36ers",95,113,"2016//17",0,18
"437",2017-01-09,"19:30","Brisbane Bullets","Perth Wildcats",68,72,"2016//17",0,4
"438",2017-01-12,"19:30","Adelaide 36ers","Melbourne United",100,73,"2016//17",1,27
"439",2017-01-13,"19:30","Illawarra Hawks","Brisbane Bullets",85,80,"2016//17",1,5
"440",2017-01-13,"17:30","NZ Breakers","Sydney Kings",92,74,"2016//17",1,18
"441",2017-01-14,"21:30","Perth Wildcats","Adelaide 36ers",84,95,"2016//17",0,11
"442",2017-01-14,"19:30","Melbourne United","Cairns Taipans",92,85,"2016//17",1,7
"443",2017-01-15,"15:00","Brisbane Bullets","NZ Breakers",82,84,"2016//17",0,2
"444",2017-01-16,"19:30","Cairns Taipans","Perth Wildcats",80,78,"2016//17",1,2
"445",2017-01-19,"19:30","Adelaide 36ers","Brisbane Bullets",101,68,"2016//17",1,33
"446",2017-01-20,"21:30","Perth Wildcats","Cairns Taipans",84,78,"2016//17",1,6
"447",2017-01-20,"19:30","Illawarra Hawks","NZ Breakers",86,95,"2016//17",0,9
"448",2017-01-21,"19:30","Adelaide 36ers","Sydney Kings",87,73,"2016//17",1,14
"449",2017-01-21,"17:30","Brisbane Bullets","Melbourne United",88,71,"2016//17",1,17
"450",2017-01-22,"17:00","NZ Breakers","Perth Wildcats",86,82,"2016//17",1,4
"451",2017-01-22,"15:00","Cairns Taipans","Illawarra Hawks",85,79,"2016//17",1,6
"452",2017-01-26,"17:30","NZ Breakers","Cairns Taipans",81,94,"2016//17",0,13
"453",2017-01-27,"19:30","Brisbane Bullets","Sydney Kings",77,80,"2016//17",0,3
"454",2017-01-28,"21:30","Perth Wildcats","Melbourne United",73,71,"2016//17",1,2
"455",2017-01-28,"19:30","Illawarra Hawks","Adelaide 36ers",95,92,"2016//17",1,3
"456",2017-01-29,"19:00","Cairns Taipans","Brisbane Bullets",97,83,"2016//17",1,14
"457",2017-01-29,"15:00","Sydney Kings","NZ Breakers",84,57,"2016//17",1,27
"458",2017-02-03,"21:30","Perth Wildcats","Brisbane Bullets",94,63,"2016//17",1,31
"459",2017-02-03,"19:30","Illawarra Hawks","Cairns Taipans",90,73,"2016//17",1,17
"460",2017-02-04,"19:30","Sydney Kings","Melbourne United",76,89,"2016//17",0,13
"461",2017-02-04,"17:30","Adelaide 36ers","NZ Breakers",87,88,"2016//17",0,1
"462",2017-02-05,"15:00","Cairns Taipans","Perth Wildcats",85,77,"2016//17",1,8
"463",2017-02-06,"19:30","Melbourne United","Illawarra Hawks",78,72,"2016//17",1,6
"464",2017-02-09,"19:30","Cairns Taipans","Adelaide 36ers",89,85,"2016//17",1,4
"465",2017-02-10,"21:30","Perth Wildcats","Sydney Kings",101,74,"2016//17",1,27
"466",2017-02-10,"17:30","NZ Breakers","Melbourne United",88,70,"2016//17",1,18
"467",2017-02-11,"19:30","Adelaide 36ers","Cairns Taipans",89,98,"2016//17",0,9
"468",2017-02-11,"17:30","Illawarra Hawks","Brisbane Bullets",106,79,"2016//17",1,27
"469",2017-02-12,"15:00","Melbourne United","Perth Wildcats",94,96,"2016//17",0,2
"470",2017-02-16,"19:30","Adelaide 36ers","Illawarra Hawks",93,78,"2016//17",1,15
"471",2017-02-17,"19:30","Cairns Taipans","Perth Wildcats",69,91,"2016//17",0,22
"472",2017-02-19,"15:00","Illawarra Hawks","Adelaide 36ers",100,94,"2016//17",1,6
"473",2017-02-20,"21:30","Perth Wildcats","Cairns Taipans",74,66,"2016//17",1,8
"474",2017-02-23,"19:30","Adelaide 36ers","Illawarra Hawks",98,106,"2016//17",0,8
"475",2017-02-26,"19:00","Perth Wildcats","Illawarra Hawks",89,77,"2016//17",1,12
"476",2017-03-01,"19:30","Illawarra Hawks","Perth Wildcats",77,89,"2016//17",0,12
"477",2017-03-05,"15:00","Perth Wildcats","Illawarra Hawks",95,86,"2016//17",1,9
"478",2017-10-05,"19:30","Adelaide 36ers","Melbourne United",97,99,"2017/18",0,2
"479",2017-10-06,"19:30","Cairns Taipans","Illawarra Hawks",88,87,"2017/18",1,1
"480",2017-10-07,"20:30","Perth Wildcats","Brisbane Bullets",96,86,"2017/18",1,10
"481",2017-10-07,"17:30","Sydney Kings","Adelaide 36ers",96,105,"2017/18",0,9
"482",2017-10-08,"15:00","NZ Breakers","Cairns Taipans",71,82,"2017/18",0,11
"483",2017-10-12,"19:30","Cairns Taipans","Adelaide 36ers",70,96,"2017/18",0,26
"484",2017-10-13,"21:30","Perth Wildcats","Illawarra Hawks",74,64,"2017/18",1,10
"485",2017-10-13,"17:30","NZ Breakers","Sydney Kings",87,85,"2017/18",1,2
"486",2017-10-14,"17:30","Adelaide 36ers","Melbourne United",79,99,"2017/18",0,20
"487",2017-10-15,"15:00","Sydney Kings","Illawarra Hawks",103,87,"2017/18",1,16
"488",2017-10-19,"17:30","NZ Breakers","Sydney Kings",90,73,"2017/18",1,17
"489",2017-10-20,"21:30","Perth Wildcats","Melbourne United",89,84,"2017/18",1,5
"490",2017-10-20,"19:30","Brisbane Bullets","Cairns Taipans",83,78,"2017/18",1,5
"491",2017-10-21,"17:30","Adelaide 36ers","Sydney Kings",114,84,"2017/18",1,30
"492",2017-10-22,"19:00","Cairns Taipans","Perth Wildcats",90,69,"2017/18",1,21
"493",2017-10-22,"17:00","Illawarra Hawks","Brisbane Bullets",105,96,"2017/18",1,9
"494",2017-10-22,"15:00","Melbourne United","NZ Breakers",76,88,"2017/18",0,12
"495",2017-10-26,"21:30","Perth Wildcats","Illawarra Hawks",105,74,"2017/18",1,31
"496",2017-10-26,"19:30","Brisbane Bullets","NZ Breakers",96,101,"2017/18",0,5
"497",2017-10-27,"19:30","Cairns Taipans","Adelaide 36ers",80,84,"2017/18",0,4
"498",2017-10-28,"17:30","Brisbane Bullets","Melbourne United",87,85,"2017/18",1,2
"499",2017-10-29,"15:00","Illawarra Hawks","Sydney Kings",94,99,"2017/18",0,5
"500",2017-11-02,"19:30","Melbourne United","Cairns Taipans",87,65,"2017/18",1,22
"501",2017-11-02,"17:30","NZ Breakers","Adelaide 36ers",92,88,"2017/18",1,4
"502",2017-11-03,"21:30","Perth Wildcats","Sydney Kings",93,69,"2017/18",1,24
"503",2017-11-03,"19:30","Brisbane Bullets","Illawarra Hawks",81,112,"2017/18",0,31
"504",2017-11-04,"19:30","Cairns Taipans","NZ Breakers",70,73,"2017/18",0,3
"505",2017-11-04,"17:30","Melbourne United","Adelaide 36ers",101,84,"2017/18",1,17
"506",2017-11-05,"15:00","Sydney Kings","Illawarra Hawks",83,93,"2017/18",0,10
"507",2017-11-09,"19:30","Cairns Taipans","Melbourne United",92,69,"2017/18",1,23
"508",2017-11-09,"17:30","NZ Breakers","Perth Wildcats",88,84,"2017/18",1,4
"509",2017-11-11,"19:30","Adelaide 36ers","Illawarra Hawks",87,96,"2017/18",0,9
"510",2017-11-11,"17:30","Melbourne United","Sydney Kings",108,90,"2017/18",1,18
"511",2017-11-12,"19:00","Perth Wildcats","NZ Breakers",82,88,"2017/18",0,6
"512",2017-11-12,"15:00","Brisbane Bullets","Cairns Taipans",82,74,"2017/18",1,8
"513",2017-11-16,"19:30","Illawarra Hawks","Sydney Kings",97,93,"2017/18",1,4
"514",2017-11-17,"19:30","Brisbane Bullets","Perth Wildcats",85,90,"2017/18",0,5
"515",2017-11-18,"19:30","Cairns Taipans","Illawarra Hawks",87,66,"2017/18",1,21
"516",2017-11-18,"17:30","Adelaide 36ers","Sydney Kings",108,93,"2017/18",1,15
"517",2017-11-19,"15:00","Melbourne United","Perth Wildcats",59,91,"2017/18",0,32
"518",2017-11-19,"13:00","NZ Breakers","Brisbane Bullets",90,82,"2017/18",1,8
"519",2017-11-30,"19:30","Sydney Kings","Cairns Taipans",81,72,"2017/18",1,9
"520",2017-12-01,"19:30","Adelaide 36ers","Brisbane Bullets",84,83,"2017/18",1,1
"521",2017-12-01,"17:30","NZ Breakers","Perth Wildcats",73,89,"2017/18",0,16
"522",2017-12-02,"17:30","Cairns Taipans","Sydney Kings",80,71,"2017/18",1,9
"523",2017-12-03,"15:00","Brisbane Bullets","NZ Breakers",81,76,"2017/18",1,5
"524",2017-12-04,"19:30","Melbourne United","Illawarra Hawks",91,73,"2017/18",1,18
"525",2017-12-07,"17:30","NZ Breakers","Brisbane Bullets",96,89,"2017/18",1,7
"526",2017-12-08,"21:30","Perth Wildcats","Adelaide 36ers",88,79,"2017/18",1,9
"527",2017-12-09,"19:30","Cairns Taipans","Melbourne United",79,70,"2017/18",1,9
"528",2017-12-09,"17:30","Sydney Kings","Brisbane Bullets",77,85,"2017/18",0,8
"529",2017-12-10,"17:00","Adelaide 36ers","NZ Breakers",95,92,"2017/18",1,3
"530",2017-12-10,"15:00","Illawarra Hawks","Perth Wildcats",91,99,"2017/18",0,8
"531",2017-12-11,"19:30","Melbourne United","Sydney Kings",95,69,"2017/18",1,26
"532",2017-12-14,"19:30","Cairns Taipans","Brisbane Bullets",74,75,"2017/18",0,1
"533",2017-12-15,"17:30","NZ Breakers","Adelaide 36ers",75,90,"2017/18",0,15
"534",2017-12-16,"19:30","Illawarra Hawks","Melbourne United",78,84,"2017/18",0,6
"535",2017-12-16,"17:30","Perth Wildcats","Brisbane Bullets",76,82,"2017/18",0,6
"536",2017-12-17,"15:00","Sydney Kings","Cairns Taipans",88,69,"2017/18",1,19
"537",2017-12-21,"19:30","Sydney Kings","NZ Breakers",95,98,"2017/18",0,3
"538",2017-12-22,"19:30","Melbourne United","Adelaide 36ers",99,91,"2017/18",1,8
"539",2017-12-23,"19:30","Illawarra Hawks","Perth Wildcats",96,84,"2017/18",1,12
"540",2017-12-23,"17:30","Brisbane Bullets","Sydney Kings",95,101,"2017/18",0,6
"541",2017-12-24,"15:00","Adelaide 36ers","Cairns Taipans",75,94,"2017/18",0,19
"542",2017-12-26,"19:30","Melbourne United","Brisbane Bullets",69,68,"2017/18",1,1
"543",2017-12-28,"19:30","Illawarra Hawks","Cairns Taipans",106,102,"2017/18",1,4
"544",2017-12-29,"19:30","Adelaide 36ers","NZ Breakers",88,85,"2017/18",1,3
"545",2017-12-30,"17:30","Sydney Kings","Melbourne United",79,103,"2017/18",0,24
"546",2017-12-31,"19:00","Cairns Taipans","Perth Wildcats",68,83,"2017/18",0,15
"547",2017-12-31,"15:00","Illawarra Hawks","Brisbane Bullets",104,82,"2017/18",1,22
"548",2018-01-04,"19:30","Adelaide 36ers","Perth Wildcats",97,86,"2017/18",1,11
"549",2018-01-05,"19:30","Cairns Taipans","Brisbane Bullets",83,80,"2017/18",1,3
"550",2018-01-06,"19:30","Illawarra Hawks","Melbourne United",77,79,"2017/18",0,2
"551",2018-01-06,"17:30","Sydney Kings","Perth Wildcats",68,76,"2017/18",0,8
"552",2018-01-07,"15:00","Brisbane Bullets","Adelaide 36ers",84,95,"2017/18",0,11
"553",2018-01-07,"13:00","NZ Breakers","Cairns Taipans",82,69,"2017/18",1,13
"554",2018-01-11,"19:30","Adelaide 36ers","Cairns Taipans",100,90,"2017/18",1,10
"555",2018-01-12,"21:30","Perth Wildcats","Melbourne United",80,82,"2017/18",0,2
"556",2018-01-13,"19:30","Illawarra Hawks","NZ Breakers",90,79,"2017/18",1,11
"557",2018-01-13,"17:30","Sydney Kings","Adelaide 36ers",101,104,"2017/18",0,3
"558",2018-01-14,"15:00","Brisbane Bullets","Perth Wildcats",80,81,"2017/18",0,1
"559",2018-01-18,"17:30","NZ Breakers","Melbourne United",98,81,"2017/18",1,17
"560",2018-01-19,"21:30","Perth Wildcats","Sydney Kings",77,84,"2017/18",0,7
"561",2018-01-19,"19:30","Adelaide 36ers","Illawarra Hawks",112,90,"2017/18",1,22
"562",2018-01-20,"19:30","Cairns Taipans","NZ Breakers",81,71,"2017/18",1,10
"563",2018-01-20,"17:30","Brisbane Bullets","Melbourne United",95,103,"2017/18",0,8
"564",2018-01-21,"17:00","Illawarra Hawks","Adelaide 36ers",93,112,"2017/18",0,19
"565",2018-01-21,"15:00","Sydney Kings","Perth Wildcats",84,56,"2017/18",1,28
"566",2018-01-24,"19:30","Melbourne United","Cairns Taipans",79,68,"2017/18",1,11
"567",2018-01-27,"20:30","Perth Wildcats","NZ Breakers",90,73,"2017/18",1,17
"568",2018-01-27,"17:30","Brisbane Bullets","Adelaide 36ers",95,90,"2017/18",1,5
"569",2018-01-28,"17:00","Illawarra Hawks","Cairns Taipans",88,78,"2017/18",1,10
"570",2018-01-28,"15:00","Sydney Kings","Melbourne United",76,93,"2017/18",0,17
"571",2018-02-02,"21:30","Perth Wildcats","Adelaide 36ers",111,90,"2017/18",1,21
"572",2018-02-02,"19:30","Illawarra Hawks","NZ Breakers",73,77,"2017/18",0,4
"573",2018-02-03,"19:30","Cairns Taipans","Sydney Kings",86,93,"2017/18",0,7
"574",2018-02-03,"17:30","Melbourne United","Brisbane Bullets",69,61,"2017/18",1,8
"575",2018-02-04,"15:00","Adelaide 36ers","Perth Wildcats",94,82,"2017/18",1,12
"576",2018-02-04,"13:00","NZ Breakers","Illawarra Hawks",88,84,"2017/18",1,4
"577",2018-02-08,"19:30","Brisbane Bullets","Illawarra Hawks",99,91,"2017/18",1,8
"578",2018-02-09,"21:30","Perth Wildcats","Cairns Taipans",83,85,"2017/18",0,2
"579",2018-02-09,"19:30","Melbourne United","NZ Breakers",89,83,"2017/18",1,6
"580",2018-02-10,"17:30","Sydney Kings","Brisbane Bullets",92,80,"2017/18",1,12
"581",2018-02-11,"15:00","Illawarra Hawks","Adelaide 36ers",87,111,"2017/18",0,24
"582",2018-02-11,"13:00","NZ Breakers","Melbourne United",82,100,"2017/18",0,18
"583",2018-02-15,"19:30","Brisbane Bullets","Sydney Kings",73,90,"2017/18",0,17
"584",2018-02-16,"19:30","Melbourne United","Perth Wildcats",97,85,"2017/18",1,12
"585",2018-02-16,"17:30","NZ Breakers","Illawarra Hawks",82,84,"2017/18",0,2
"586",2018-02-17,"17:30","Adelaide 36ers","Brisbane Bullets",105,82,"2017/18",1,23
"587",2018-02-18,"19:00","Perth Wildcats","Cairns Taipans",89,61,"2017/18",1,28
"588",2018-02-18,"17:00","Sydney Kings","NZ Breakers",101,86,"2017/18",1,15
"589",2018-02-18,"15:00","Melbourne United","Illawarra Hawks",84,94,"2017/18",0,10
"590",2018-03-03,"19:30","Adelaide 36ers","Perth Wildcats",109,74,"2017/18",1,35
"591",2018-03-03,"17:30","Melbourne United","NZ Breakers",88,77,"2017/18",1,11
"592",2018-03-05,"17:30","NZ Breakers","Melbourne United",86,88,"2017/18",0,2
"593",2018-03-09,"21:30","Perth Wildcats","Adelaide 36ers",88,89,"2017/18",0,1
"594",2018-03-16,"19:30","Melbourne United","Adelaide 36ers",107,96,"2017/18",1,11
"595",2018-03-18,"15:00","Adelaide 36ers","Melbourne United",110,95,"2017/18",1,15
"596",2018-03-23,"19:30","Melbourne United","Adelaide 36ers",101,98,"2017/18",1,3
"597",2018-03-25,"15:00","Adelaide 36ers","Melbourne United",90,81,"2017/18",1,9
"598",2018-03-31,"18:00","Melbourne United","Adelaide 36ers",100,82,"2017/18",1,18
